10
46
0
6
++++++S+++++++++++++++++++++++++++++++++++++++
+++OOOOOOOO+++++++++++++++++++++++++++++++++++
+++OOOOOOOOOOOOOOOOOOOOOOOOOOOOOOOO+++++++++++
+++OOOOOOOOOOOOOOOOOOOOOOOOOOOOOOOO+++++++++++
+++++++++++++++++++++++++++++++E++++++++++++++
++++++++++++++++++++++++++++++++++++++++++++++
++++++++++++++++++++++++++++++++++++++++++++++
++++++++++++++++++++++++++++++++++++++++++++++
++++++++++++++++++++++++++++++++++++++++++++++
++++++++++++++++++++++++++++++++++++++++++++++

